11111
1C0E1
1000111111
1P00000001
1111111111
