11111
1C0E1
10001
1P001
11111
