111111111111111111
100000000010000001
100110010C10000011
111100011110101001
1P0001000E00001C01
111111111111111111
