111111111111111111
100000000010000001
10P110010C10001101
111100011110101001
1P0001000000001E01
111111111111111111
