1111   111
1C01   101
1001111101
1P000000E1
1111111111
