111111
1C0E01
1000111111
1P00000001
1111111111
