1111111111
1C0E000101
1000111101
1P00000001
111111111A
