111111111111111111
100000000010000001
100110010C10000111
111100011110101001
1P0001000000001E01
111111111111111111
