1111111111
1C0E000001
1000111111
1P001
11111
