1111111111
1C0E000101
100A111101
1P00000001
1111111111
