111111111111111111
100000010010000001
100110010C10001101
111100011110101001
1P0001000000001E01
111111111111111111
