1111111111
1C0E000001
1000111101
1P001  101
11111  111
