11111111111111111111111111111111111111111111111111
1P000000000000000000000000000000000000000000000001
10000111111111111111100000000000000000000000000001
10000100000000000000000000000000000000000000000001
10000100000000000000000000000000000000000000000001
10000100000000000000000000000000000000000000000001
10000100000000000000000000000000000000000000000001
10000100000000000000000000000000000000000000000001
10000100000000000000000000000000000000000000000001
10000100000000000000000000000000000000000000000001
10000100000000000000000000000000000000000000000001
10000100000000000000000000000000000000000000000001
10000100000000000000000000000000000000000000000001
10000100000000000000000000000000000000000000000001
10000100000000000000000000000000000000000000000001
10000100000000000000000000000000000000000000000001
10000100000000000000000000000000000000000000000001
10000100000000000000000000000000000000000000000001
10000100000000000000000000000000000000000000000001
10000100000000000000000000000000000000000000000001
10000100000000000000000000000000000000000000000001
10000100000000000000000000000000000000000000000001
10000100000000000000000000000000000000000000000001
10000100000000000000000000000000000000000000000001
10000100000000000000000000000000000000000000000001
10000100000000000000000000000000000000000000000001
10000100000000000000000000000000000000000000000001
10000100000000000000000000000000000000000000000001
10000100000000000000000000000000000000000000000001
10000100000000000000000000000000000000000000000001
10000100000000000000000000000000000000000000000001
10000100000000000000000000000000000000000000000001
10000100000000000000000000000000000000000000000001
10000100111111111111111111111111111111111111111111
10000100000000000000000000000000000000000000000001
10000100000000000000000000000010000000000000000001
10000100000000000000000000000010000000000000000001
10000100000000000000000000000010000000000000000001
10000100000000000000000000000010000000000000000001
10000100000000000000000000000010000000000000000001
10000100000000000000000000000010000000000000000001
10000100000000000000000000000010000000000000000001
10000100000000000000000000000010000000000000000001
10000100000000000000000000000010000000000000000001
10C001000000000000000000000000100000000000000000E1
11111111111111111111111111111111111111111111111111
