111111111111111111
100000000010000001
100110010C10001101
111100011110101001
1P0001000000001001
111111111111111111
