111111111111111111
1C000000001C100001
100110010C10101101
111100011110101001
1P0001000000001E01
111111111111111111
