111111111111111111111111111111111111111111111111111111111111
100100011000110000010001010100000010011100000001000000C10001
110001111101110111111101010001111000111111111011011111011101
100000010000010111110000000100111000100000000011011000010001
100E0000000100010001000110C001111000101110111011000011000111
100000010001110001111101110011100011101111111000011110010001
100000011100011011111101110000001011000000001111111111011011
1001000110001100000100010101000000100111000000010000C0010001
110001111101110111111101010001111000111111111011011111011101
100000010000010000000000000100111000100000000011011000010001
100000000001000100010001100001111000101110111011000011000111
100000010001110001111101110011100011101111111000011110010001
100000011100011011111101110000001011101111111111111111011011
100100011000110000010001010100000010011100000001000000010001
110001111101110111111101010001111000111111111011011111011101
100000010000010111110000000100111000100000000011011000010001
10000000000100010001000110000111100C101110111011000011000111
100000010001110001111101110011100011101111111000011110010001
100000011100011011111101110000001011000000001111111111011011
100100011000110000000001010100000010011100000001000000010001
110001111101110111111101010001111000111111111011011111011101
100000010000010111110000000100111000100000000011011000010001
100000000001000100010001100001111000101110111011000011000111
100000010001110001111101110011100011101111111000011110010001
100000011100011011111101110000001011101111111101111111011011
10010C011000110000010001010100000010011100000C01000000010001
110001111101110111111101010001111000111111111011011111011101
100000010000010001110000000100111000100000000011011000010001
10000000000100010C010001100001111P00101110111011000011000111
111111111111111111111111111111111111111111111111111111111111